31,30,30,30,0,30,30,30,30,31
0,0,0,0,0,0,0,0,0,0
31,24,24,24,24,24,24,24,0,31
31,0,0,0,0,0,0,27,0,31
31,0,24,24,24,24,0,27,0,31
31,0,0,0,0,0,0,0,0,31
31,0,24,24,24,24,24,24,0,31
0,0,28,0,0,0,0,27,0,0
31,0,0,0,0,27,0,0,0,31
31,30,30,30,0,30,30,30,30,31
